32
40 22
GGGGGGGGGGGGGGGGGGGGGGGGGGGGGGGGGGGGGGGG
G                                      G
G                                      G
G                                      G
G                                      G
G                                      G
G      TTTTTTTTT                       G
G      RRRRRRRRR                       G
G      `````````                       G
G                                      G
G                 P                    G
G                                      G
G                                      G
G                                      G
G                                      G
G                                      G
G                                      G
G                                      G
G                                      G
G                                      G
G                                      G
GGGGGGGGGGGGGGGGGGGGGGGGGGGGGGGGGGGGGGGG

6666666666666666666666666666666666666666
6666666666666666666666666666666666666666
6666666666666666666666666666666666666666
6666666666666666666666666666666666666666
6666666666666666666666666666666666666666
6666666666666666666666666666666666666666
6666666666666666666666666666666666666666
6666666666666666666666666666666666666666
6666666666666666666666666666666666666666
6666666666666666666666666666666666666666
6666666666666666666666666666666666666666
6666666666666666666666666666666666666666
6666666666666666666666666666666666666666
6666666666666666666666666666666666666666
6666666666666666666666666666666666666666
6666666666666666666666666666666666666666
6666666666666666666666666666666666666666
6666666666666666666666666666666666666666
6666666666666666666666666666666666666666
6666666666666666666666666666666666666666
6666666666666666666666666666666666666666
6666666666666666666666666666666666666666
